20 20
....................
....................
....................
..################..
..#..............#..
..#..............#..
..#..##########..#..
..#..#........#..#..
..#..#........#..#..
..#..#..#..G..#..#..
..#..#..#.....#..#..
..#..#..#######..#..
..#..#...........#..
..#..#...........#..
..#..###############
..#.................
..#...............S.
..################..
.................#..
.................#..
